11113331423333
14011121120003
11200120021123
11112311111021
00002300003021
31111121111211
40000020001003
11121111201003
00620001200603
21110121111121
23323121331021
11123120334021
05020022111111
11120111133333