333300330330000200
111130421112111211
342011123302030203
112003320602111011
032111101112000030
002036000000463311
111111213030111133
004000202112000000
021200202011221134
400120112043123311
112112032111120033
332332112303021111
052000302303020000
111111111341120333