33211112333333332
11204062110120002
00201112000621112
11112002131120303
42002111103111121
11112033130130023
02302111103134623
02302300130111111
11111112140223031
02330002111110301
02004332000203031
31121112111210341
50020002000211111
11113001111133333